11111111111111111
1E000C11100C00C01
11100011C10000001
101a0C00000110011
1P000000011010111
11111001000000011
11111111111111111